A Kolbold Story
An Interactive Fiction by Spencer Apple, Colin Taylor, Derrick Wong
Release 1 / Serial number 130302 / Inform 7 build 6G60 (I6/v6.32 lib 6/12N) SD

Hovel
The hovel is cramped, made of mud, and precisely the right size to house two kolbolds and their 13 spawns.

You can see leaf overhang, a hay matt, a pile of candlesticks and Pazpot here.

>go through leaf overhang
(first opening leaf overhang)

Outside the Hovel
You can see leaf overhang here.

* * *

A Kolbold Story
An Interactive Fiction by Spencer Apple, Colin Taylor, Derrick Wong
Release 1 / Serial number 130302 / Inform 7 build 6G60 (I6/v6.32 lib 6/12N) SD

Hovel
The hovel is cramped, made of mud, and precisely the right size to house two kolbolds and their 13 spawns.

You can see leaf overhang, a hay matt, a pile of candlesticks and Pazpot here.

>go through the leaf overhang
(first opening leaf overhang)

Outside the Hovel
A wetter area directly outside of the hovel.

You can see leaf overhang here.

* * *

A Kolbold Story
An Interactive Fiction by Spencer Apple, Colin Taylor, Derrick Wong
Release 1 / Serial number 130302 / Inform 7 build 6G60 (I6/v6.32 lib 6/12N) SD

Hovel
The hovel is cramped, made of mud, and precisely the right size to house two kolbolds and their 13 spawns.

You can see leaf overhang, a hay matt, a pile of candlesticks and Pazpot here.

>go through the overhang
(first opening leaf overhang)

Outside the Hovel
A wetter area directly outside of the hovel.

You can see leaf overhang here.

>x hovel
A small lump of earth blends in to the surrounding dirt hills.

* * *

A Kolbold Story
An Interactive Fiction by Spencer Apple, Colin Taylor, Derrick Wong
Release 1 / Serial number 130302 / Inform 7 build 6G60 (I6/v6.32 lib 6/12N) SD

Hovel
The hovel is cramped, made of mud, and precisely the right size to house two kolbolds and their 13 spawns.

You can see leaf overhang, a hay matt, a pile of candlesticks and Pazpot here.

>You hide
That's not a verb I recognise.

>Hide
What do you want to hide?

>hide yourself
You hide.

>look around
You can't see any such thing.

>look room
You can't see any such thing.

>turn left
You can't see any such thing.

>go west
(first opening leaf overhang)

Outside the Hovel
A wetter area directly outside of the hovel.

You can see leaf overhang here.

>hide yourself
You hide.

>hide yourself
You hide.

>hide inventory
You can't see any such thing.

>hide overhang
You hide.

>hide poop
You can't see any such thing.

>hide hay matt
You can't see any such thing.

>hide a pile of candlesticks
You can't see any such thing.

>pick up pile of candlesticks
You can't see any such thing.

>hide everoyne
You can't see any such thing.

>hide everything
You can't use multiple objects with that verb.

* * *

A Kolbold Story
An Interactive Fiction by Spencer Apple, Colin Taylor, Derrick Wong
Release 1 / Serial number 130302 / Inform 7 build 6G60 (I6/v6.32 lib 6/12N) SD

Hovel
The hovel is cramped, made of mud, and precisely the right size to house two kolbolds and their 13 spawns.

You can see leaf overhang, a hay matt, a pile of candlesticks and Pazpot here.

>explore room
That's not a verb I recognise.

>look around room
You can't see any such thing.

>look at hove
You can't see any such thing.

>look at hovel
You can't see any such thing.

>examine orc
You can't see any such thing.

* * *

A Kolbold Story
An Interactive Fiction by Spencer Apple, Colin Taylor, Derrick Wong
Release 1 / Serial number 130302 / Inform 7 build 6G60 (I6/v6.32 lib 6/12N) SD

Hovel
The hovel is cramped, made of mud, and precisely the right size to house two kolbolds and their 13 spawns.

You can see leaf overhang, a hay matt, a pile of candlesticks and Pazpot here.

>go east
You can't go that way.

>go west
(first opening leaf overhang)

Outside the Hovel
A wetter area directly outside of the hovel.

You can see leaf overhang here.

>talk to Orc
That's not a verb I recognise.

>examine Orc
You can't see any such thing.

>fight Orc
You can't see any such thing.

>peek Orc
That's not a verb I recognise.

>look around
You can't see any such thing.

* * *

>go west
(first opening leaf overhang)

Outside the Hovel
A wetter area directly outside of the hovel.

You can see leaf overhang here.

>go east
Hovel
The hovel is cramped, made of mud, and precisely the right size to house two kolbolds and their 13 spawns.

You can see leaf overhang, a hay matt, a pile of candlesticks and Pazpot here.

>go west
Outside the Hovel
A wetter area directly outside of the hovel.

You can see leaf overhang here.

>go north
Outside1

>go south
Outside the Hovel
A wetter area directly outside of the hovel.

You can see leaf overhang here.

>go east
Hovel
The hovel is cramped, made of mud, and precisely the right size to house two kolbolds and their 13 spawns.

You can see leaf overhang, a hay matt, a pile of candlesticks and Pazpot here.

* * *

>go west
Outside the Hovel
A wetter area directly outside of the hovel.

You can see leaf overhang here.

>go west
You can't go that way.

>go south
You can't go that way.

>go north
Outside1

>go north
You can't go that way.

>go east
Outside2

>go north
Outside3

>go east
You can't go that way.

>go west
You can't go that way.

>go north
You can't go that way.

>go south
Outside2

>go east
You can't go that way.

>go west
Outside1

>go east
Outside2

* * *

>go north
Outside3

>go south
Outside2

>go south
You can't go that way.

* * *

A Kolbold Story
An Interactive Fiction by Spencer Apple, Colin Taylor, Derrick Wong
Release 1 / Serial number 130302 / Inform 7 build 6G60 (I6/v6.32 lib 6/12N) SD

Hovel
The hovel is cramped, made of mud, and precisely the right size to house two kolbolds and their 13 spawns.

You can see leaf overhang, a hay matt, a pile of candlesticks and Pazpot here.

>go outside
You can't go that way.

>go Outside the Hovel
I only understood you as far as wanting to go outside.

>go west
(first opening leaf overhang)

Outside the Hovel
A wetter area directly outside of the hovel.

You can see leaf overhang here.

>fight the orcs
I only understood you as far as wanting to fight the exterior of the hovel.

>the rocs
That's not a verb I recognise.

>the orcs
That's not a verb I recognise.

>examine the orcs
I only understood you as far as wanting to examine the exterior of the hovel.

>talk to the orcs
That's not a verb I recognise.

>speak to the orcs
I didn't understand that sentence.

>talk the orcs
That's not a verb I recognise.

* * *

A Kolbold Story
An Interactive Fiction by Spencer Apple, Colin Taylor, Derrick Wong
Release 1 / Serial number 130302 / Inform 7 build 6G60 (I6/v6.32 lib 6/12N) SD

Hovel
The hovel is cramped, made of mud, and precisely the right size to house two kolbolds and their 13 spawns.

You can see leaf overhang, a hay matt, a pile of candlesticks and Pazpot here.

>go west
(first opening leaf overhang)

Outside the Hovel
A wetter area directly outside of the hovel.

You can see leaf overhang here.

>go north
Outside1
Nearby land #1

>go east
Outside2
Nearby land #2

>go north
Outside3
Nearby land, contains necklace.

Hmm... seems to be a "Necklace of human teeth".

>pick up necklace
Taken.

>inventory
You are carrying:
  a necklace

* * *

A Kolbold Story
An Interactive Fiction by Spencer Apple, Colin Taylor, Derrick Wong
Release 1 / Serial number 130302 / Inform 7 build 6G60 (I6/v6.32 lib 6/12N) SD

Hovel
The hovel is cramped, made of mud, and precisely the right size to house two kolbolds and their 13 spawns.

You can see leaf overhang, a hay matt, a pile of candlesticks and Pazpot here.

>go northeast
You can't go that way.

>go northwest
You can't go that way.

>go southwest
You can't go that way.

>go southeast
You can't go that way.

* * *

A Kolbold Story
An Interactive Fiction by Spencer Apple, Colin Taylor, Derrick Wong
Release 1 / Serial number 130302 / Inform 7 build 6G60 (I6/v6.32 lib 6/12N) SD

Hovel
The hovel is cramped, made of mud, and precisely the right size to house two kolbolds and their 13 spawns.

You can see leaf overhang, a hay matt, a pile of candlesticks and Pazpot here.

>go north
You can't go that way.

>go east
You can't go that way.

* * *

>pick up necklace
Taken.

>hide necklace
You hide.

* * *

A Kolbold Story
An Interactive Fiction by Spencer Apple, Colin Taylor, Derrick Wong
Release 1 / Serial number 130302 / Inform 7 build 6G60 (I6/v6.32 lib 6/12N) SD

Hovel
The hovel is cramped, made of mud, and precisely the right size to house two kolbolds and their 13 spawns.

You can see leaf overhang, a hay matt, a pile of candlesticks and Pazpot here.

>go west
(first opening leaf overhang)

Outside the Hovel
A wetter area directly outside of the hovel.

You can see Orc Base Gates and leaf overhang here.

>go northwest
(first opening Orc Base Gates)

Firepit
Mmmm... firepit marshmallows sound good right now.

You can see Orc Base Gates here.

It's quiet.. Seems empty.  Hopefully they're in the Caves.

>go southwest
Black Orc Tent

>got west
That's not a verb I recognise.

>go north
Orange Orc Tent
Nothing, but beds and that foul stench.

* * *

>go northwest
(first opening Orc Base Gates)

Firepit
Mmmm... firepit marshmallows sound good right now.

You can see Orc Base Gates here.

It's quiet.. Seems empty.  Hopefully they're in the Caves.

>go southeast
You can't go that way.

>go orc base gates
Firepit
Mmmm... firepit marshmallows sound good right now.

A breeze goes by... fear is in the air.

* * *

>go southeast
You can't go that way.

>go north
Outside1
Nearby land #1

* * *

>go west
(first opening leaf overhang)

Outside the Hovel
A wetter area directly outside of the hovel.

You can see Orc Base Gates and leaf overhang here.

>go northeast
You can't go that way.

>go northwest
(first opening Orc Base Gates)

Firepit
Mmmm... firepit marshmallows sound good right now.

You can see Orc Base Gates here.

It's quiet.. Seems empty.  Hopefully they're in the Caves.

>go north
War Room Tent
Maps? Small Figures? ...this must be their War Room.  It sure smells like it.

>go north
Red Orc Tent
Jail Cells? Can it be?!  ...a prison tent?!